27;7;7
# 1 0 1 # # #
# 1 2 2 2 # #
1 2 # # 2 3 #
1 3 # # # 2 2
# 2 2 3 2 # 2
# 3 3 3 2 # 2
# 2 # # # # 1