16;5;5
# 1 0 1 #
# 1 2 2 2
1 2 # # 3
1 3 # # #
# 2 2 3 2
